................................................................................
................................................................................
.......*...............................*................................*.......
.......*...............................*................................*.......
.......*...............................*................................*.......
...***...***........*..............***...***..............*.........***...***...
.......*............*..................*..................*.............*.......
.......*............*..................*..................*.............*.......
.......*............*..................*..................*.............*.......
....................*.....................................*.....................
................***...***........**.........**........***...***.................
....................*............**.........**............*.....................
....................*.....................................*.....................
....................*.....................................*.....................
.......*............*..................*..................*.............*.......
.......*............*..................*..................*.............*.......
.......*............*..................*..................*.............*.......
...***...***........*..............***...***..............*.........***...***...
.......*...............................*................................*.......
.......*...............................*................................*.......
.......*...............................*................................*.......
................................................................................
................................................................................
